XXXXXXXXXXXXXXXXXXXXXXXXXXXXXXXXXXXXXXXXX
XXX XXX XXX XXXXXXX   X   X          XXXX
XXX   X X   XXXXX   X XXX X XXXXXXXX X  q
X   X X XXX X     XXX X   X  X    XX X XX
X XXX    XX X XXXXX   X XXXX X XX    X XX
X X XXXXXX  X XXX   XXX    X X XXXXXXX XX
X X    XXXX     X XXXXX X XX X     X   XX
X X XXXX  X XXX X       X X  XXXXX X XXXX
X X XXXXX X X X X XXXX XX X XXX    X XXXX
X X     X X X X XXXXXX X  X  XX XXXX XXXX
X X X XXX X X X      X XXXXX XX    X XXXX
X X X XXX X X X XXXX X X      XXXXXX XXXX
X   X     X X X X  X X X XXXXXXX     XXXX
XXX XXX XXX X X X XX X X       X XXXXXXXX
XXX XXX XXX   X X XX X X XXXXXXX XXXXXXXX
X     X X XXX X X XX X X XX    X XXXXXXXX
X XXXXX X XXX X X    X X XX XX X    XXXXX
X XX    X   X X XXXXXX X    XX XXXX XXXXX
X XX XXXX X X X      X XXXXXX  XXXX XXXXX
X  X XXXX X X XXXXXX X      X XXXXX XXXXX
XX X      X X     XX X XXXX X X   X    XX
XX XXXX XXX XXXXX XX X XX X X X X XXXX XX
X     X XXX     X XX XXXX X X X X XXXX XX
X XXXXXXXXX XXX X         X X X X XXXX XX
X X       X X X XXXXXXXXX X X X X      XX
X X XXX XXX X X     XXXXX X X X XXXXXXXXX
X X XXX XXX X XXXX XX     X   X         X
X X   X XXX X      XX XXX XXXXXXXXXXXXX X
X XXX X   X XXXXXX X  XX    X    X   XX X
X   X XXX XXXXXX XXXXXXX XXXX XX X X XX X
X X X XXX      X     X   X    XX X X    X
X X     XXXXXX X XXX X XXX XXXXX X XXXXXX
X XXXXX XXXXXX X XXX X   X    XX X     XX
X     X X      X XXX XXX XXXX X  XXXXX XX
XXXXX X X XXXXXX   X     X    X XXXXXX XX
e   X X X    XXXXX X XXXXX XXXX X    X  X
XXX X X XXXX X   X X X   X X    X XX XX X
X   X X X    X X X X X X X X XXXX X   X X
X XXX X X XXXX X X XXX X X X XX   X XXX X
X     X X      X       X   X    XXX     X
XXXXXXXXXXXXXXXXXXXXXXXXXXXXXXXXXXXXXXXXX