XXXXXXXXXX
e X   X  X
X X X X XX
X   X X XX
XXX X X XX
X   X   XX
X XXXXXXXX
X XXX    X
X     XX q
XXXXXXXXXX