XXXXXXXXXXXXXXXXXXXX
X    X      X     XX
X XX X XX XXX XXX XX
X XXXX XX XXX X   XX
X      XX     X XXXX
X XX XXXX XXXXX    X
X XXXXX   X     XXXX
X     X XXXXXXXXXXXX
XXXXX X X   X      X
e   X X   X X XX X X
XXX X XXXXX X  X X X
XXX X X   XXXX XXX q
X   X X X    X XXXXX
X XXX X XXX XX     X
X XXX X   X XXXXXX X
X     XXX X      X X
XXX X XXX XXX X XX X
X   X XXX XXX X XX X
XXXXX     X   X    X
XXXXXXXXXXXXXXXXXXXX