BBLLLLLLBB
BXFXXFXXFB
LXXRXXFXXL
LXXRXXRXXL
LXFXXFXXFL
LXXRXXRXXL
LXXFXXFXXL
LXRXXRXXRL
BXFXXFXXFB
BBLLLLLLBB